####################################################################################################
#                                      #                          #                        #       #
#                                      #                          #                        #       #
#                                      #                          #                        #       #
#                                      #                          #                        #       #
#                                      #                          #                        #       #
#                                      #                          #                        #       #
#                                      #                          #                        #       #
#                                      #               #          #                        #       #
#                                      #               #          #                        #       #
#                                                      #          #                        #       #
#                                      ############################                        #       #
#                                      #                          #                        #       #
#                                                                 #                        #       #
#                                      #                          #                        #       #
#                                      #                          #                        #       #
#                                      #                          #                        #       #
#                                      #                          #                        #       #
#                                      #                          #                        #       #
#                                                                 #                        #       #
#                                      #                          #                        #       #
#                                      #                          #                        #       #
#                                      #                          #                        #       #
#                                      #                          #                        #       #
#                                      #                          #                        #       #
#                                      #                          #                        #       #
#                                      #                          #                        #       #
#                                      #                          #                        #       #
#                                      #                          #                        #       #
#                                      #                          #                        #       #
####################################################################################################