########################################
#                                      #
#                                      #
#                                      #
#>                                     #
#>                                     #
#>                                     #
#>                                     #
#>                                     #
#>                                     #
#>                                     #
#>                                     #
#>                                     #
#>                                     #
#>                                     #
#>                                     #
#>                                     # 
#>                                     #
#>                                     #
########################################