#################################################
#         #               #         #           #
#    S    #       #       #    Q    #     E     #
#         #       ###---###         #           #
#         #       # #   # #         #           #
##### #####  ###  ###---### #########           #
#         #       # #   # #         #           #
#*        #       ###---########### ###### ######
#         ###---### #   # #         #           #
#        *#       ###---### ######### ######### #
#         #       # #   # #         #           #
#*        #       ###---########### #           #
#         #       #       #         #           #
#                 #                             #
#################################################