#################################################
#   #S#   #       !       #         #           #
#   #!#   #       #       #    Q    #     E     #
#         #     * ###---###         #           #
#         #       # #   # #         #           #
#####!#####  ###  ###---### #########           #
#         #       # #   # #         #           #
#         #       ###---########### ###### ######
#         ####!#### #   # #         #           #
#         #       ###---### ######### ######### #
#         #       # #   # #         #           #
#         #       ###---########### #           #
#         #       #       #         #           #
#                 #                             #
#################################################