#################################################
#   #S#   #     # !       #         #           #
#   #!#   #     # #       #    Q    #     E     #
#         #     * ###---###         #           #
#         #       # #   # #         #           #
#####!#####  ###  ###---### #########           #
#         #       # #   # #         #           #
#         #       ###---########### ###### ######
#         ####!#### #   # #         #           #
#         #  #    ###---### ######### ######### #
#         #  ###  # #   # #         #           #
#         #       ###---########### #           #
#         #       #       #         #           #
#                 #                             #
#################################################