###########     #################################
#   #S#   #     # !       #         #           #
#   #!#   ####### #       #    Q    #     E     #
#         #     < ###---###         #           #
#         #       # #   # #         #           #
#####!#####  ###  ###---### #########           #
#         #       # #   # #         #           #
#         #       ###---########### ######!######
#         ####!#### #   # #         #           #
#         #  #    ###---### ######### ######### #
#         #  ###  # #   # #         #           #
#         #       ###---########### #           #
#         #       #       #         #           #
#                 #       !                     #
#################################################