#################################################
#         #               #         #           #
#    S    #       #       #    Q    #     E     #
#         #       ###---###         #           #
#         #       # #   # #         #           #
##### #####  ###  ###---### #########           #
#         #       # #   # #         #           #
#>        #       ###---########### ###### ######
#         ###---### #   # #         #           #
#        <#       ###---### ######### ######### #
#         #       # #   # #         #           #
#>        #       ###---########### #           #
#         #       #       #         #           #
#                 #                             #
#################################################