###########     #################################
#   #S#   #     # !       #                     #
#   #!#   ####### #       #    Q    #           #
#         #     < ###---###         #           #
#         #       # #   # #         #           #
#####!#####  ###  ###---### ######### ######### #
#         #       # #   # #         #           #
##        #       ###---########### ######!######
#         ####!#### #   # #         #           #
#!#########  #    ###---### #########           #
#         #  ###  # #   # #         #           #
#         #       ###---########### #           #
#         #       #       #         #     E     #
#       # !       #     # !         #           #
#################################################