####################################################################################################
##                                      ##                           ##                           ##
##                                      ##                           ##                           ##
##                                      ##                           ##                           ##
##                                      ##                           ##                           ##
##                                      ##                           ##                           ##
##                                      ##                           ##                           ##
##                                      ##                           ##                           ##
##                                      ##               ##          ##                           ##
##                                      ##               ##          ##                           ##
##                                                       ##          ##                           ##
##                                      ###############################                           ##
##                                      ##                           ##                           ##
##                                                                   ##                           ##
##                                      ##                           ##                           ##
##                                      ##                           ##                           $^
##                                      ##                           ##                           (%
##                                      ##                           ##                           ##
##                                      ##                           ##                           ##
##                                      ##                                                        ##
##                                      ##                           ##                           ##
##                                      ##                           ##                           ##
##                                      ##                           ##                           ##
##               S                      ##                           ##                           ##
##                                      ##                           ##                           ##
##                                      ##                           ##                           ##
##                                      ##                           ##                           ##
##                                      ##                           ##                           ##
##                                      ##                           ##                           ##
##                                      ##                           ##                           ##
####################################################################################################