####################################################################################################
##       ##       ##                              ##       ##                   ##        ##      ##
##   S   ##       ##                                       ##   #####   #####   ##   ##   ##      ##
##       ##       ##        #########             ##       ##      ##   ##      ##   ##   ##      ##
##       ##       ##               ##             ##       ##########   ##########   ##   ##      ##
##       ##       ##          ##   ##             ##                                 ##           ##
##       ##       ##          ##   ##             ##       ################     ####################
##       ##       ##############   #################       ##            ##   ##                  ##
##   ######                                                     ######   ##     ##                ##
##       ##       ##################################       #######  ##   ##       ##              ##
##       ##       ##             ##               ##       ##   ##  ##   ##       ############    ##
######   ##       ##      ##     ##               ##       ##   ##  ##   ##      ##         ##    ##
##       ##       ##      ##     ##               ##       #######  ##   ####   ##     ##   ##    ##
##       ##       ##      ##     ##      ##                ##               ##              ##    ##
##       ##               ##     ##      ##                ##   ##########  ##################  ####
##       ##       ##########     ##      ##       ##       ##   ##                                ##
##                ##             ##      ##       ##       ##   ##  ##############                ##
##                ##        #######      ##       ##       ##   ##              ##            $^  ##
##                ##                     ##       ##            ##              ##            (%  ##
####################################################################################################