############    #################################              ################      ##########         ##########
# Q#       #    #         #                     #              #              #  ### #        #     #####        #
#  #       #    # ####### ######### ########### #     ##########              #  # # #        #######            #
#  #       #    # #     # #       # #         # #     #                       #  # # #                ############
# ###### ###    # #    ## #       # #         # #     # ########              #  # # ########### ######           
#      # ######## #    #  #   ##### ######    # #     # #      #              #  # #           # #                
# #### #          #    # ##   #          #    # #     # #  #####              #  # ##########  # #  ##############
### ## ########## #    #  #   ##### ######    # ####### #  #                  #  #          #  # #  #            #
# # ##          # #    ## #       # #         #         #  #  #################  ####### ####  # #  #         E  #
# # ########### # ##### # #       # #         ######### #  #  #################  #   ### ####### #  #            #
#     -    -  # - -   # # ######### ##########        # #  #                  #  #   #           #  #            #
# ### ######### # ##### #                    ########## ########### ######### #  #   #           #  #            #
# # #-#       # #    #  #################### #   #           #    # #       # #  #   #           #  ########## ###
# #          ## #### #               # #   #######           #    # ####### # ################## #           # #  
# # #-###### ## #### ##############  # #         #     S     #    #       - -                    #           # #  
# #  -     ---     #              # ##############           #    # ####### # #################### ########### #  
# ###-     #-#################### # #                        #    # #       # #                    #           #  
# #  -     #   #    -      -    # # # ########################    # #       ###   ### ############## #############
# # #-###  #      ###      #    # ###-####                        # #             # # #   #          #     #     #
# # #   #  ########        ###  #        # ######################## ############### # ##### ##########     # #####
# # #   -                  -    #        # #                                        # #       -   #        # #   #
# ###############################        # # ################### ################## # ########### ####     # #   #
#       #       #        #               # # #                 # #                # # #           -  #     # #   #
####### # ##### # ###### # ######        # # #                 # ###############  # # ############## ####### #   #
      #   #   #   #    #   #    #####-#### # #                 #               #  # # #                   -  #   #
###########   #####   ##########    #-#    # #  ################ ############# #  # # ###################### #   #
#         #           #        #    #-#    # #  #                #           #-#  # #                      # #   #
#         ############# ###### ###### ###### #  ################ ############# ######     ################## #####
#         #             #                    #                 #  -               #########                      #
######### # #########################-########################################-############ ######################
        #   #                       # #                                                     #                     
        #####                       # ######################################## ##############                      
                                    ###                                      ###                                    